	C 0,15,223
F      255 ,0, 0
NO					./textures/greystone.xpm
	EA	./textures/eagle.xpm
SO			./textures/red.xpm
	R 4000 4000
S ./textures/barrel.xpm


WE	./textures/purplestone.xpm

111111111111111111111111111111111111111111111111
1000E000000000000000000000000000000000000000
10000000000000000000000000000000000000000000
10000000000000000000000000000000000000000000
10000000000000000000000000000000000000000000
10000000000000000000000000000000000000000000
111111111111111111111111111111111111111111111111
